map size - [47, 47]
quantization error - 0.923705729298
topographic error - 0.215277777778
topographic error and quantization error average - 0.569491753538
density - 0.782254413762
HIT map - 
4 4 4 0 4 4 0 4 0 4 0 4 0 4 0 4 0 4 4 0 0 4 0 4 4 4 4 0 0 0 0 4 0 0 4 0 0 8 0 0 0 8 0 0 8 0 8 
0 4 0 0 0 0 4 0 0 4 0 0 0 0 0 0 4 0 0 0 0 0 0 0 0 0 0 0 8 0 0 4 0 0 4 0 0 0 0 0 0 0 0 0 0 0 0 
0 0 0 0 0 0 0 0 0 0 0 0 0 0 0 0 0 0 0 0 0 0 4 0 0 0 0 0 0 0 0 0 0 0 0 0 0 4 0 0 0 8 0 0 0 0 8 
4 4 0 0 4 0 4 0 0 0 0 4 0 0 4 4 0 0 0 4 0 4 0 0 0 0 4 0 0 0 0 0 4 0 0 0 0 4 0 0 0 0 0 0 8 0 0 
0 0 4 0 0 0 0 0 0 4 0 0 0 0 0 0 4 0 0 0 0 0 0 0 4 0 0 0 4 0 4 0 0 0 4 0 0 0 0 0 0 0 0 0 0 0 0 
4 0 0 0 0 4 0 4 0 0 0 4 4 0 0 4 0 0 0 0 0 0 0 0 0 0 0 0 0 0 0 0 0 0 0 0 0 4 0 0 0 8 0 0 8 0 0 
0 0 4 0 0 0 0 0 0 0 0 0 0 0 0 0 0 0 4 4 0 4 4 0 0 4 0 0 0 0 4 0 0 0 0 0 0 4 0 0 0 0 0 0 0 0 8 
4 0 0 4 0 0 0 0 0 4 0 0 0 0 0 0 0 0 0 0 0 0 0 0 0 0 0 0 0 0 0 0 4 0 4 0 0 0 0 4 0 0 0 0 0 0 0 
4 0 0 0 0 0 0 4 0 0 4 0 0 4 0 4 0 4 0 0 0 0 0 0 0 0 4 0 0 0 0 0 0 0 0 0 0 0 0 4 0 0 0 4 0 0 0 
0 0 0 4 0 0 4 0 0 0 0 4 0 0 0 0 0 0 0 0 0 0 0 0 4 0 0 0 4 0 4 0 0 0 0 0 0 0 0 0 0 4 0 0 0 0 8 
0 4 0 0 0 0 0 0 0 0 0 0 0 0 0 4 0 0 0 0 4 0 4 0 0 0 0 0 0 0 0 0 0 0 4 0 4 0 0 0 0 0 0 0 0 0 0 
0 4 0 4 0 0 4 0 4 0 4 0 0 0 0 0 0 0 4 0 0 0 0 0 0 0 0 0 0 0 0 0 4 0 0 0 0 0 0 4 0 0 0 4 4 0 0 
0 0 0 0 0 0 0 0 0 0 0 0 0 0 0 0 0 0 0 0 0 0 0 0 0 4 0 4 0 4 0 0 0 0 4 0 0 0 0 0 0 4 0 0 0 0 8 
4 0 0 0 0 0 0 0 0 0 0 0 4 0 0 4 0 0 0 4 0 0 0 4 0 0 0 0 0 0 0 0 0 0 0 0 4 0 0 0 0 0 0 0 0 0 0 
4 0 0 4 0 4 0 0 0 0 4 0 0 0 0 0 0 4 0 0 0 4 0 0 0 0 4 0 0 0 4 0 4 0 0 0 0 0 0 0 0 0 4 4 0 0 0 
0 0 0 0 0 0 0 4 4 0 0 0 0 4 0 0 0 0 0 0 0 0 4 0 4 0 0 0 0 0 0 0 0 0 0 0 4 0 4 0 0 0 0 0 0 0 8 
4 0 0 4 0 0 0 0 0 0 0 4 0 0 0 0 0 4 0 0 0 0 0 0 0 0 0 0 0 0 4 0 4 0 0 0 0 0 0 0 4 0 0 0 0 0 0 
4 0 0 0 0 4 0 0 0 0 0 0 0 0 0 0 4 0 0 4 0 4 0 0 0 0 4 0 4 0 0 0 0 0 4 0 4 0 0 0 0 0 0 4 4 0 0 
0 0 0 0 0 0 0 4 0 4 0 0 0 4 0 0 0 0 0 0 0 0 0 0 4 0 0 0 0 0 0 0 0 0 0 0 0 4 0 4 0 0 0 0 0 0 4 
0 0 0 0 0 0 0 0 0 0 0 4 0 0 0 4 0 0 0 4 0 0 0 0 0 0 0 4 0 0 4 0 0 0 0 0 0 0 0 0 0 4 4 0 0 0 4 
4 0 0 4 0 0 0 0 0 0 0 0 0 0 0 0 0 0 0 0 4 0 0 4 0 0 0 0 0 0 0 4 0 0 4 0 0 0 0 0 0 0 0 0 0 0 0 
4 0 0 0 0 0 4 0 0 0 0 0 0 4 0 0 0 4 0 0 0 0 0 0 0 4 0 0 0 4 0 0 0 0 4 0 0 0 4 4 0 0 0 4 0 0 4 
0 0 4 0 0 0 0 0 4 0 4 0 0 0 0 0 0 0 0 0 0 0 4 0 0 0 0 0 0 0 0 4 0 0 0 0 4 0 0 0 0 0 4 0 0 0 4 
0 0 0 0 4 0 0 0 0 0 0 0 0 0 0 4 0 0 4 0 0 0 0 0 4 0 0 0 4 0 0 0 0 0 0 0 4 0 0 0 0 0 0 0 0 0 0 
8 0 0 0 0 0 4 0 0 0 0 0 0 0 0 0 0 0 0 0 0 4 0 0 0 0 4 0 0 4 0 0 0 0 0 0 0 0 0 4 0 0 0 4 0 0 4 
0 0 0 0 0 0 0 0 4 0 0 4 0 4 0 0 0 4 0 0 0 0 0 0 0 0 0 0 0 0 0 0 4 0 0 4 0 0 0 4 0 0 0 4 0 0 4 
4 0 4 0 0 4 0 0 0 0 0 0 0 0 0 0 0 0 0 0 0 4 0 0 0 0 0 0 4 0 0 0 0 0 0 0 0 4 0 0 0 0 0 0 0 0 0 
0 0 0 0 0 0 0 0 4 0 0 4 0 0 4 0 0 0 0 0 0 0 0 0 4 0 0 0 0 0 0 0 4 0 0 4 0 0 0 0 0 4 0 0 0 0 0 
0 4 0 4 0 0 0 0 0 0 0 0 0 0 0 0 0 0 0 4 0 0 0 0 0 0 4 0 0 0 0 0 0 0 0 0 0 4 0 0 0 0 0 0 4 0 4 
4 0 0 0 0 0 0 0 0 0 0 0 0 0 0 0 4 0 0 0 0 4 0 0 0 0 0 0 0 0 4 0 0 0 4 0 0 0 0 0 4 0 0 0 0 0 0 
0 0 0 0 4 0 4 0 4 0 4 0 4 0 4 0 0 0 0 0 0 0 0 0 4 0 0 4 0 0 0 0 0 0 0 0 4 0 0 0 0 0 0 0 0 0 8 
4 0 4 0 0 0 0 0 0 0 0 0 0 0 0 0 0 0 0 0 0 0 0 0 0 0 0 0 0 0 4 0 0 4 0 0 0 0 4 0 0 0 4 4 0 0 0 
4 0 0 4 0 0 0 0 0 4 0 0 0 4 0 0 0 4 0 0 4 0 0 0 0 0 0 0 0 0 0 0 0 0 4 0 0 0 0 0 0 0 0 0 0 4 4 
0 0 0 0 0 0 4 0 0 0 0 4 0 0 0 0 0 0 0 0 0 0 4 0 4 0 4 0 0 0 0 0 0 0 0 0 4 0 0 0 4 0 0 0 0 0 0 
4 0 0 0 4 0 0 0 0 0 0 0 0 0 0 4 0 0 4 0 0 0 0 0 0 0 0 0 4 0 0 0 0 0 0 0 0 0 0 0 0 0 0 4 4 0 0 
0 0 4 0 0 0 4 0 0 4 0 0 0 0 0 0 0 0 0 0 0 0 4 0 0 0 0 0 0 0 4 0 0 0 4 0 0 0 4 0 0 4 0 0 0 0 8 
4 0 0 0 4 0 0 0 0 0 0 0 4 0 0 4 0 0 0 4 0 0 0 0 0 4 0 0 0 0 0 0 4 0 0 0 0 0 0 0 4 0 0 0 0 0 0 
4 0 4 0 0 0 0 0 4 0 0 0 0 0 0 0 0 0 0 4 0 0 4 0 0 0 0 0 4 0 0 0 0 0 0 0 4 0 0 0 0 0 4 0 0 0 8 
0 0 0 0 0 0 4 0 0 0 0 0 4 0 0 0 4 0 0 0 0 0 0 0 0 4 0 0 0 0 4 0 0 0 4 0 0 4 0 0 4 0 0 0 0 0 0 
4 0 4 0 0 4 0 0 0 4 0 0 0 0 0 0 0 0 0 0 4 0 0 0 0 0 0 0 4 0 0 4 0 0 0 0 0 0 0 0 0 0 0 4 0 0 4 
4 0 0 4 0 0 0 0 0 0 0 0 0 4 0 0 4 0 0 0 4 0 0 0 0 4 0 0 0 0 0 0 0 0 4 0 0 0 4 0 0 0 4 0 4 0 4 
0 0 0 0 0 0 8 0 0 4 0 0 0 0 0 0 0 0 0 0 0 0 0 0 0 4 0 0 4 0 0 0 0 0 0 0 4 0 0 0 0 0 0 0 4 0 0 
0 0 0 0 0 0 0 0 0 0 0 0 4 0 0 0 0 4 0 4 0 0 8 0 0 0 0 0 0 0 4 0 0 0 0 0 0 0 4 0 4 0 0 0 0 0 0 
8 0 0 8 0 0 0 0 0 0 0 0 0 0 4 0 4 0 0 0 0 0 0 0 0 4 0 0 4 0 0 4 0 4 0 4 0 4 0 0 0 0 4 0 0 0 4 
0 0 0 0 0 0 0 8 0 0 0 4 0 0 0 0 0 0 0 4 0 0 0 0 0 4 0 0 0 0 0 0 0 0 0 0 0 0 0 0 0 0 0 4 0 0 4 
0 0 0 0 0 0 0 0 0 0 0 0 0 4 0 0 0 4 0 0 0 4 0 0 0 0 0 0 4 0 0 0 0 4 0 0 0 0 4 0 4 0 0 0 0 0 0 
8 0 8 0 0 8 0 0 0 8 0 4 0 4 0 8 0 4 0 4 0 4 0 0 8 0 0 4 0 0 4 4 0 0 4 4 0 4 0 4 0 4 0 4 0 4 4 

