map size - [18, 18]
quantization error - 0.171902673339
topographic error - 0.0
topographic error and quantization error average - 0.0859513366696
density - 0.462962962963
HIT map - 
1 1 0 1 0 2 0 0 1 0 1 0 1 0 3 0 1 2 
0 0 0 1 0 0 2 0 2 0 0 1 0 1 0 0 0 0 
1 0 1 0 3 0 0 0 0 1 0 2 0 0 1 0 2 1 
0 0 1 1 0 0 1 1 0 0 1 1 1 0 1 0 1 0 
1 0 0 0 1 0 0 1 0 2 0 0 1 1 0 0 0 0 
0 0 0 0 0 0 0 0 0 0 0 1 0 0 0 0 0 1 
1 2 1 0 0 1 0 1 0 0 0 0 0 0 0 1 1 0 
0 0 0 1 0 0 0 1 1 0 0 0 0 1 0 0 0 1 
1 0 0 1 1 1 1 0 1 1 1 1 2 0 2 0 0 0 
0 1 0 0 0 0 1 0 0 0 1 0 0 1 0 0 0 1 
3 0 1 1 2 0 0 0 0 0 0 0 0 1 0 1 0 1 
0 0 0 1 0 1 0 2 0 2 1 0 1 0 0 0 1 1 
1 0 0 0 0 1 0 0 0 0 1 0 1 0 1 0 0 0 
0 1 0 0 0 0 0 1 0 0 0 1 0 1 1 1 0 1 
1 0 1 1 1 0 0 0 1 1 0 0 0 1 1 0 2 1 
1 0 0 0 0 0 2 0 0 0 0 1 0 1 0 0 0 0 
0 0 0 2 0 0 0 1 0 0 0 1 0 0 0 1 0 1 
1 1 0 1 1 0 2 0 1 0 1 0 2 0 2 0 0 2 

