map size - [23, 24]
quantization error - 0.393930603042
topographic error - 0.0802011012689
topographic error and quantization error average - 0.237065852156
density - 7.56702898551
HIT map - 
8 7 9 10 7 9 11 8 11 9 10 9 16 8 11 9 9 17 20 17 14 0 5 33 
6 2 3 6 3 3 5 5 5 10 8 4 4 8 2 7 15 11 1 0 1 0 15 13 
8 8 6 11 6 3 7 9 8 7 3 10 10 6 13 9 3 0 0 8 0 10 15 19 
5 5 6 4 5 4 5 5 4 8 4 8 10 8 6 0 0 5 12 0 5 19 11 17 
7 6 5 8 4 9 5 10 5 7 8 6 7 3 0 1 8 11 6 0 9 16 7 20 
10 7 7 6 7 5 3 7 2 6 8 9 0 0 2 12 7 6 1 0 14 14 8 16 
6 3 6 5 3 8 12 6 8 10 3 0 0 10 7 9 6 14 1 0 16 10 14 12 
10 8 10 7 5 10 6 7 6 13 0 0 8 7 6 6 12 8 0 2 20 17 12 10 
10 4 5 6 11 13 3 9 6 2 0 13 10 5 10 7 7 3 0 5 13 18 14 16 
13 9 11 9 6 16 4 5 13 0 7 10 4 7 9 7 12 5 0 15 16 9 16 10 
8 3 8 9 14 5 1 12 0 3 6 6 10 7 5 5 9 0 0 10 6 17 6 9 
12 7 13 9 8 4 7 0 1 8 6 10 8 10 3 12 7 0 4 12 16 12 11 10 
13 11 9 10 8 10 3 0 12 13 11 3 9 6 5 7 3 0 9 9 13 5 12 11 
12 6 7 7 5 5 0 8 6 1 2 7 11 9 10 12 1 0 12 9 9 7 13 9 
8 8 9 9 10 5 2 4 7 10 12 5 7 3 5 10 0 3 8 11 10 11 5 11 
21 7 3 10 4 3 7 7 9 10 4 7 12 9 9 10 0 8 8 6 10 8 6 11 
8 8 9 5 3 3 4 6 8 9 5 13 8 13 7 0 0 8 7 10 4 13 8 7 
13 11 10 8 0 6 7 10 10 9 11 10 6 7 6 0 5 6 9 12 6 12 5 14 
17 6 3 4 5 10 11 9 9 8 7 8 11 11 0 4 10 10 5 8 7 10 2 6 
15 5 4 8 3 8 9 7 9 9 6 8 17 2 2 7 9 6 8 3 8 3 3 6 
12 9 7 8 9 15 12 10 5 10 9 10 3 0 10 10 10 12 9 7 2 9 4 7 
12 3 8 6 11 10 8 4 10 7 8 0 1 8 4 7 7 6 3 6 5 6 1 4 
17 6 12 9 16 11 14 12 7 11 17 1 13 11 13 6 10 10 5 10 2 8 3 7 

