map size - [16, 16]
quantization error - 1.32232671299
topographic error - 0.0
topographic error and quantization error average - 0.661163356496
density - 0.6953125
HIT map - 
5 0 1 1 1 1 2 2 0 2 1 2 1 2 0 2 
0 1 1 2 0 0 0 1 0 0 0 0 0 1 0 1 
1 0 0 1 0 0 0 0 2 2 0 0 0 1 0 0 
2 0 1 0 1 1 3 0 0 1 0 0 2 1 0 1 
1 0 1 0 1 0 0 0 0 0 1 1 0 1 1 1 
0 1 1 1 0 2 0 0 1 0 1 0 1 0 1 2 
2 0 1 0 0 1 0 0 0 1 0 0 1 0 1 0 
0 0 0 0 1 0 0 0 1 1 0 0 1 1 0 0 
0 0 2 0 0 0 0 2 0 1 0 3 1 1 0 3 
1 0 1 1 0 0 1 1 0 0 1 0 0 0 1 2 
2 0 0 1 2 1 0 0 2 1 0 0 0 0 0 2 
3 0 1 1 0 2 0 1 1 0 0 2 0 2 1 0 
0 1 1 0 0 2 0 1 1 0 1 1 0 0 0 3 
1 1 1 1 1 0 0 1 1 0 0 0 0 1 0 1 
2 0 0 0 0 0 1 1 0 1 0 0 0 0 0 0 
4 0 2 1 2 2 3 1 2 0 0 3 0 1 1 3 

