map size - [20, 13]
quantization error - 0.665822448548
topographic error - 0.0
topographic error and quantization error average - 0.332911224274
density - 0.823076923077
HIT map - 
1 0 1 0 0 2 0 1 0 2 0 3 3 
0 0 0 0 0 0 0 0 1 0 0 1 2 
1 1 1 2 0 0 1 1 0 0 0 0 0 
0 0 1 0 1 0 0 0 0 1 0 0 2 
0 2 1 4 1 1 3 1 0 0 0 0 4 
3 0 0 1 0 3 1 0 1 0 1 2 0 
1 0 1 2 0 0 1 0 0 0 0 1 2 
4 0 1 1 0 1 3 0 1 0 0 0 0 
1 2 1 0 3 1 1 0 1 0 1 0 1 
3 1 2 1 0 1 0 2 0 0 0 0 0 
2 0 0 1 1 1 0 1 1 0 0 0 2 
1 0 0 0 1 3 1 0 0 3 1 0 1 
1 2 2 1 0 0 1 0 0 0 0 1 0 
2 0 1 1 0 0 2 2 0 0 1 1 1 
1 1 0 2 2 1 1 1 0 2 0 0 1 
3 0 1 0 1 0 0 1 0 1 0 0 2 
2 2 1 2 1 0 2 0 1 1 2 0 0 
3 0 0 1 0 0 2 0 0 0 1 1 2 
2 1 1 0 0 1 2 1 0 1 0 0 1 
2 1 1 1 3 2 0 4 3 1 1 0 2 

