map size - [18, 20]
quantization error - 3.4226773946
topographic error - 0.451923076923
topographic error and quantization error average - 1.93730023576
density - 0.577777777778
HIT map - 
4 1 1 2 0 2 2 0 3 3 0 2 4 0 2 3 0 3 0 5 
0 0 0 1 0 0 1 0 1 0 0 1 0 0 0 1 0 0 0 0 
2 0 1 1 0 0 1 1 0 0 0 0 0 1 0 0 1 0 0 1 
0 0 0 0 1 3 0 0 1 0 3 1 1 0 1 1 0 0 0 0 
4 0 0 2 0 2 0 0 1 0 1 0 0 0 2 0 0 1 1 2 
2 1 0 0 1 1 0 0 0 0 0 1 1 0 0 1 0 0 0 0 
1 0 1 0 0 1 1 0 1 0 1 1 1 0 0 2 0 1 0 2 
1 0 0 0 0 1 0 0 1 0 1 0 1 0 1 0 1 1 0 1 
3 0 0 1 0 1 0 0 1 0 0 0 0 0 2 1 0 0 2 0 
2 0 1 0 0 0 0 2 0 1 0 1 0 0 0 0 0 0 0 0 
0 0 1 0 0 2 0 0 0 0 0 0 0 0 0 1 0 1 0 3 
2 1 0 1 1 0 1 0 0 1 2 0 0 3 0 1 0 0 0 2 
0 0 0 0 1 0 0 0 0 1 0 1 0 0 1 0 1 0 0 1 
3 0 1 0 0 1 0 0 2 1 1 0 1 0 1 0 1 1 1 1 
0 0 0 0 1 0 1 0 1 0 0 0 0 0 0 2 0 0 0 1 
2 0 0 1 0 0 0 0 0 0 0 1 0 0 0 0 0 0 0 0 
1 0 0 0 0 0 0 0 1 0 0 0 0 0 0 1 0 0 0 1 
3 0 2 1 1 1 1 0 1 2 0 2 1 0 1 2 2 0 1 2 

