map size - [13, 19]
quantization error - 1.15489638755
topographic error - 0.238425925926
topographic error and quantization error average - 0.696661156736
density - 6.995951417
HIT map - 
16 16 0 16 0 16 0 16 16 0 16 16 0 8 16 0 32 4 20 
0 16 0 16 0 16 0 16 16 0 0 0 0 24 0 16 0 8 16 
16 0 0 16 0 16 0 0 0 0 16 12 0 0 0 0 0 0 0 
16 0 16 0 0 16 0 32 0 8 0 4 0 0 0 24 8 8 12 
0 16 16 0 16 0 0 0 0 12 12 0 0 16 8 0 0 0 8 
32 0 0 0 0 8 16 0 8 20 4 0 16 0 16 8 0 0 16 
0 0 16 8 0 8 0 0 0 0 0 0 12 0 8 0 0 4 0 
32 0 0 8 0 0 0 8 16 8 0 0 12 0 16 8 8 4 8 
16 8 8 0 0 16 0 8 8 0 16 0 8 0 8 8 8 8 8 
0 0 0 0 16 0 12 8 4 0 4 4 4 4 8 8 8 8 8 
32 16 16 0 16 0 8 12 4 8 12 8 0 8 8 8 8 8 8 
0 0 0 0 0 16 0 16 0 8 4 4 0 12 0 16 0 0 16 
32 32 0 16 16 16 8 8 0 16 16 16 0 16 4 0 16 0 16 

